{
  "schema": "gm-helper-catalog-pack-v1",
  "meta": {
    "group": "common",
    "id": "common-item-quality-map",
    "version": "1.0.0",
    "source": "manual",
    "updatedAt": "2026-04-09T22:30:00+08:00"
  },
  "entries": [
    {
      "kind": "item_quality_map",
      "itemQualityById": {
        "201001": "1",
        "202001": "1",
        "202002": "2",
        "202003": "3",
        "202004": "4",
        "202005": "5",
        "202006": "6",
        "203001": "1",
        "203002": "2",
        "203003": "3",
        "203004": "4",
        "203005": "5",
        "203006": "6",
        "204001": "1",
        "204002": "2",
        "204003": "3",
        "204004": "4",
        "204005": "5",
        "204006": "6",
        "205001": "1",
        "205002": "2",
        "205003": "3",
        "205004": "4",
        "205005": "5",
        "205006": "6",
        "207001": "1",
        "207002": "2",
        "207003": "3",
        "207004": "4",
        "207005": "5",
        "207006": "6",
        "301001": "1",
        "301002": "2",
        "301003": "3",
        "301004": "4",
        "301005": "5",
        "301006": "6",
        "302001": "1",
        "302002": "2",
        "302003": "3",
        "302004": "4",
        "302005": "5",
        "302006": "6",
        "303001": "1",
        "303002": "2",
        "303003": "3",
        "303004": "4",
        "303005": "5",
        "303006": "6",
        "304001": "1",
        "304002": "2",
        "304003": "3",
        "304004": "4",
        "304005": "5",
        "304006": "6",
        "305001": "1",
        "305002": "2",
        "305003": "3",
        "305004": "4",
        "305005": "5",
        "305006": "6",
        "502001": "1",
        "502101": "2",
        "502201": "3",
        "502301": "4",
        "502401": "5",
        "502501": "6"
      }
    }
  ]
}
